ares	HARDWARE STEWARD HOSTING INTRANET
eros	HARDWARE STEWARD HOSTING INTRANET
hera	HARDWARE STEWARD HOSTING INTRANET
zeus	HARDWARE STEWARD HOSTING INTRANET
enyo	DISTRICT STEWARD PRESIDE INTRANET
gaia	DISTRICT STEWARD PRESIDE INTRANET
leto	DISTRICT STEWARD PRESIDE INTRANET
maia	DISTRICT STEWARD PRESIDE INTRANET
atlas	DISTRICT STEWARD STORAGE INTRANET
crius	DISTRICT STEWARD STORAGE INTRANET
moros	DISTRICT STEWARD STORAGE INTRANET
theia	DISTRICT STEWARD STORAGE INTRANET
apate	DISTRICT STEWARD MESSAGE INTRANET
geras	DISTRICT STEWARD MESSAGE INTRANET
momus	DISTRICT STEWARD MESSAGE INTRANET
tyche	DISTRICT STEWARD MESSAGE INTRANET
apollo	DISTRICT STEWARD CONTENT INTRANET
erebus	DISTRICT STEWARD CONTENT INTRANET
pontus	DISTRICT STEWARD CONTENT INTRANET
moirai	DISTRICT STEWARD CONTENT INTRANET
aether	DISTRICT STEWARD SESSION INTRANET
hemera	DISTRICT STEWARD SESSION INTRANET
typhon	DISTRICT STEWARD SESSION INTRANET
uranus	DISTRICT STEWARD SESSION INTRANET
cronus	DISTRICT STEWARD CONTENT EXTRANET
hermes	DISTRICT STEWARD CONTENT EXTRANET
phoebe	DISTRICT STEWARD CONTENT EXTRANET
themis	DISTRICT STEWARD CONTENT EXTRANET
artemis	DISTRICT STEWARD ROUTING INTERNET
clymene	DISTRICT STEWARD ROUTING INTERNET
demeter	DISTRICT STEWARD ROUTING INTERNET
eunomia	DISTRICT STEWARD ROUTING INTERNET
